WWWWWWWWWWWWWWWWWWWW
EFFFFFFFFFFFFFFFFFFW
WWWWWFWWWWWFWWWWFWFW
WFFCWFFFWWFFFFFFFWFW
WFWWWFWFWWWWWWWWFWCW
WFFFFFWFWWWWWWWWFWWW
WWWWWFWFFFFFFFFFFWCW
WFCFWFWWCWFWWWWWFFFW
WFWFWFWWWWFFFFFFFWFW
WFFFFFFFFWFWWFWWWWFW
WFWWWWWWFWFWWFWWFFFW
WFFFFFFFFWFWWFFWFWCW
WWWWWWWWFFFWWWFWFWWW
WCFFFFFFFWFFFFFFFFFX
WWWWWWWWWWWWWWWWWWWW